,recording_name,frame_interval_start,frame_interval_end,frame_interval,body_idx_0,body_0_des
0,recording_20210907_S02_S01_01,1551,2000,449,0 female,stand_casual_chat_clip1
1,recording_20210907_S02_S01_01,2000,2421,421,0 female,stand_casual_chat_clip2
2,recording_20210907_S02_S01_01,2421,2632,211,0 female,stretch_squat_yoga_clip1
3,recording_20210907_S02_S01_01,2632,2840,208,0 female,stand_casual_chat_clip3
4,recording_20210907_S03_S04_01,1421,1800,379,0 male,take_class_teach_clip1
5,recording_20210907_S03_S04_01,1800,2180,380,0 male,take_class_teach_clip2
6,recording_20210907_S04_S03_01,2001,2470,469,0 female,take_class_sit_down_clip1
7,recording_20210907_S04_S03_01,2470,2940,470,0 female,take_class_demonstrate_clip1
8,recording_20210907_S04_S03_02,1601,2101,500,0 female,take_class_teach_clip3
9,recording_20210907_S04_S03_02,2101,2750,649,0 female,take_class_teach_clip4
10,recording_20210910_S05_S06_01,1451,1674,223,0 male,stand_casual_chat_clip4
11,recording_20210910_S05_S06_01,1674,1900,226,0 male,sit_casual chat_clip1
12,recording_20210910_S05_S06_01,1900,2400,500,0 male,sit_casual chat_clip2
13,recording_20210910_S05_S06_01,2400,2961,561,0 male,sit_casual chat_clip3
14,recording_20210910_S05_S06_01,2961,3500,539,0 male,stand_casual_chat_clip5
15,recording_20210910_S05_S06_01,3500,4000,500,0 male,stand_casual_chat_clip6
16,recording_20210910_S05_S06_01,4000,4490,490,0 male,stand_casual_chat_clip7
17,recording_20210910_S06_S05_01,951,1365,414,0 female,stand_casual_chat_clip8
18,recording_20210910_S06_S05_01,1365,1870,505,0 female,stand_casual_chat_clip9
19,recording_20210910_S06_S05_02,1661,2261,600,0 female,swimming_casual chat_clip1
20,recording_20210910_S06_S05_02,2261,2835,574,0 female,swimming_casual chat_clip2
21,recording_20210910_S06_S05_02,2835,3244,409,0 female,stand_casual_chat_clip10
22,recording_20210910_S06_S05_02,3244,3790,546,0 female,stand_casual_chat_clip11
23,recording_20210910_S06_S05_03,2251,2737,486,0 female,teach_dance_clip1
24,recording_20210910_S06_S05_03,2737,3180,443,0 female,teach_dance_clip2
25,recording_20210911_S06_S07_01,2261,2422,161,0 male,sit_down_clip1
26,recording_20210911_S06_S07_01,2422,2934,512,0 male,sit_casual chat_clip4
27,recording_20210911_S06_S07_01,2934,3434,500,0 male,sit_casual chat_clip5
28,recording_20210911_S06_S07_01,3434,3927,493,0 male,sit_casual chat_clip6
29,recording_20210911_S06_S07_01,3927,4402,475,0 male,sit_casual chat_clip7
30,recording_20210911_S06_S07_01,4402,4640,238,0 male,stand_casual_chat_clip12
31,recording_20210911_S06_S07_02,901,1403,502,0 male,catch_toss_pick_up_pen_clip1
32,recording_20210911_S06_S07_02,1403,1905,502,0 male,catch_toss_pick_up_pen_clip2
33,recording_20210911_S06_S07_02,1905,2445,540,0 male,catch_toss_pick_up_pen_clip3
34,recording_20210911_S06_S07_02,2445,2993,548,0 male,catch_toss_pick_up_pen_clip4
35,recording_20210911_S06_S07_02,2993,3590,597,0 male,catch_toss_pick_up_pen_clip5
36,recording_20210911_S07_S06_01,1101,1262,161,0 male,pass_pen_clip1
37,recording_20210911_S07_S06_01,1262,1762,500,0 male,bungee_jumping_casual_chat_clip1
38,recording_20210911_S07_S06_01,1762,2352,590,0 male,bungee_jumping_casual_chat_clip2
39,recording_20210911_S07_S06_01,2352,2843,491,0 male,bungee_jumping_casual_chat_clip3
40,recording_20210911_S07_S06_01,2843,3230,387,0 male,bungee_jumping_casual_chat_clip4
41,recording_20210911_S07_S06_02,901,1350,449,0 male,kick_pen_clip1
42,recording_20210911_S07_S06_02,1350,1800,450,0 male,kick_pen_clip2
43,recording_20210911_S07_S06_03,1861,2235,374,0 male,kick_pen_clip3
44,recording_20210911_S07_S06_03,2235,2600,365,0 male,kick_pen_clip4
45,recording_20210911_S08_S03_01,1541,2097,556,0 male,stand_casual_chat_clip13
46,recording_20210911_S08_S03_01,2097,2532,435,0 male,sit_casual chat_clip8
47,recording_20210911_S08_S03_01,2532,3025,493,0 male,stand_casual_chat_clip14
48,recording_20210911_S08_S03_01,3025,3533,508,0 male,stand_casual_chat_clip15
49,recording_20210911_S08_S03_01,3533,3974,441,0 male,stand_casual_chat_clip16
50,recording_20210911_S08_S03_01,3974,4430,456,0 male,stand_casual_chat_clip17
51,recording_20210911_S08_S03_02,2101,2550,449,0 male,stand_casual_chat_clip18
52,recording_20210911_S08_S03_03,2681,3272,591,0 male,stand_casual_chat_clip19
53,recording_20210911_S08_S03_03,3272,3450,178,0 male,sit_casual chat_clip9
54,recording_20210911_S03_S08_01,1401,1903,502,0 female,stand_casual_chat_clip20
55,recording_20210911_S03_S08_01,1903,2468,565,0 female,stand_casual_chat_clip21
56,recording_20210911_S03_S08_01,2468,2880,412,0 female,stand_casual_chat_clip22
57,recording_20210911_S03_S08_02,3061,3443,382,0 female,stand_casual_chat_clip23
58,recording_20210911_S03_S08_02,3443,3880,437,0 female,stand_casual_chat_clip24
59,recording_20210918_S05_S06_01,2241,2540,299,0 female,pantry_sit_on_sofa_casual chat_clip1
60,recording_20210918_S05_S06_01,2540,2671,131,0 female,pantry_stand_casual_chat_clip1
61,recording_20210918_S05_S06_01,2671,3147,476,0 female,pantry_sit_on_sofa_casual chat_clip2
62,recording_20210918_S05_S06_01,3147,3620,473,0 female,pantry_sit_on_sofa_casual chat_clip3
63,recording_20210918_S06_S05_01,1811,2009,198,0 male,pantry_sit_casual chat_clip1
64,recording_20210918_S06_S05_01,2009,2160,151,0 male,pantry_fetch_glass_clip1
65,recording_20210918_S06_S05_01,2160,2760,600,0 male,pantry_sit_casual chat_clip2
66,recording_20210918_S06_S05_01,2760,2910,150,0 male,pantry_hand_out_glass_clip1
67,recording_20210918_S06_S05_01,2910,3100,190,0 male,pantry_stand_up_clip1
68,recording_20210918_S06_S05_02,3271,3623,352,0 male,pantry_stand_casual_chat_clip2
69,recording_20210918_S06_S05_02,3623,3870,247,0 male,pantry_sit_on_sofa_casual chat_clip4
70,recording_20210918_S05_S06_02,751,900,149,0 female,pantry_walk_in_clip1
71,recording_20210918_S05_S06_02,900,1430,530,0 female,pantry_sit_on_sofa_listen_clip1
72,recording_20210918_S05_S06_02,1430,1950,520,0 female,pantry_sit_on_sofa_listen_clip2
73,recording_20210918_S05_S06_02,1950,2490,540,0 female,pantry_sit_on_sofa_listen_clip3
74,recording_20210918_S05_S06_02,2490,3067,577,0 female,pantry_sit_on_sofa_listen_clip4
75,recording_20210918_S05_S06_02,3067,3454,387,0 female,pantry_stand_listen_clip1
76,recording_20210918_S05_S06_02,3454,3990,536,0 female,pantry_sit_on_sofa_listen_clip5
77,recording_20210918_S06_S05_03,955,1480,525,0 male,pantry_sit_on_sofa_casual chat_clip5
78,recording_20210918_S05_S06_03,1001,1191,190,0 female,pantry_walk_and_then_sit_on_sofa_casual_chat_clip1
79,recording_20210918_S05_S06_03,1191,1691,500,0 female,pantry_sit_on_sofa_casual chat_clip6
80,recording_20210918_S05_S06_03,1691,2105,414,0 female,pantry_sit_on_sofa_casual chat_clip7
81,recording_20210918_S05_S06_03,2105,2653,548,0 female,pantry_sit_on_sofa_casual chat_clip8
82,recording_20210918_S05_S06_03,2653,2910,257,0 female,pantry_sit_on_sofa_casual chat_clip9
83,recording_20210918_S05_S06_04,3211,3645,434,0 female,pantry_sit_on_sofa_casual chat_clip10
84,recording_20210918_S05_S06_04,3645,4090,445,0 female,pantry_sit_on_sofa_casual chat_clip11
85,recording_20210918_S05_S06_05,901,1226,325,0 female,pantry_walk_and_then_sit_on_sofa_casual_chat_clip2
86,recording_20210918_S05_S06_05,1226,1753,527,0 female,pantry_sit_on_sofa_casual_chat_clip1
87,recording_20210918_S05_S06_05,1753,2285,532,0 female,pantry_sit_on_sofa_casual_chat_clip2
88,recording_20210918_S05_S06_05,2285,2744,459,0 female,pantry_sit_on_sofa_casual_chat_clip3
89,recording_20210918_S05_S06_05,2744,3164,420,0 female,pantry_sit_on_sofa_casual_chat_clip4
90,recording_20210918_S05_S06_05,3164,3371,207,0 female,pantry_stand_up_and_then_stand_casual_chat_clip1
91,recording_20210918_S05_S06_05,3371,3493,122,0 female,pantry_sit_down_casual_chat_clip1
92,recording_20210918_S05_S06_05,3493,3990,497,0 female,pantry_sit_on_sofa_casual_chat_clip5
93,recording_20210918_S09_S05_01,1551,1710,159,0 female,pantry_walk_and_then_sit_on_sofa_casual_chat_clip3
94,recording_20210918_S09_S05_01,1710,1962,252,0 female,pantry_sit_on_sofa_casual_chat_clip6
95,recording_20210918_S09_S05_01,1962,2182,220,0 female,pantry_stand_up_and_then_sit_down_casual_chat_clip1
96,recording_20210918_S09_S05_01,2182,2378,196,0 female,pantry_sit_on_sofa_casual_chat_clip7
97,recording_20210918_S09_S05_01,2378,2490,112,0 female,pantry_fetch_glass_clip2
98,recording_20210918_S09_S05_02,3001,3476,475,0 female,pantry_sit_on_sofa_casual chat_clip12
99,recording_20210918_S09_S05_02,3476,3856,380,0 female,pantry_sit_on_sofa_casual chat_clip13
100,recording_20210918_S09_S05_02,3856,4265,409,0 female,pantry_sit_on_sofa_casual chat_clip14
101,recording_20210918_S09_S05_02,4265,4450,185,0 female,pantry_stand_up_and_then_sit_down_casual_chat_clip2
102,recording_20210918_S05_S09_01,1391,1590,199,0 female,pantry_stand_up_and_then_sit_down_casual_chat_clip3
103,recording_20210918_S05_S09_01,1590,2176,586,0 female,pantry_sit_on_sofa_casual chat_clip15
104,recording_20210918_S05_S09_01,2176,2588,412,0 female,pantry_sit_on_sofa_casual chat_clip16
105,recording_20210918_S05_S09_01,2588,2950,362,0 female,pantry_sit_on_sofa_casual chat_clip17
106,recording_20210918_S09_S05_03,1721,2120,399,0 female,pantry_sit_on_sofa_casual chat_clip18
107,recording_20210918_S09_S05_03,2120,2520,400,0 female,pantry_sit_on_sofa_casual chat_clip19
108,recording_20210921_S10_S11_01,1171,1735,564,0 male,cabin_sit_on_bench_casual_chat_clip1
109,recording_20210921_S10_S11_01,1735,2234,499,0 male,cabin_sit_on_bench_casual_chat_clip2
110,recording_20210921_S10_S11_01,2234,2823,589,0 male,cabin_sit_on_bench_casual_chat_clip3
111,recording_20210921_S10_S11_01,2823,3360,537,0 male,cabin_sit_on_bench_casual_chat_clip4
112,recording_20210921_S11_S10_01,1111,1261,150,0 male,cabin_sit_on_bench_casual_chat_clip5
113,recording_20210921_S11_S10_01,1261,1940,679,0 male,cabin_stand_up_and_then_explain_and_stretch_clip1
114,recording_20210921_S11_S10_02,2091,2642,551,0 male,cabin_stand_casual_chat_clip1
115,recording_20210921_S11_S10_02,2642,3074,432,0 male,cabin_demonstrate_flying_clip1
116,recording_20210921_S11_S10_02,3074,3256,182,0 male,cabin_sit_down_and_then_demostrate_flying_clip1
117,recording_20210921_S11_S10_02,3256,3870,614,0 male,cabin_sit_on_bench_casual_chat_clip6
118,recording_20210921_S10_S11_02,1031,1622,591,0 male,cabin_learn_to_dance_clip1
119,recording_20210921_S10_S11_02,1622,2133,511,0 male,cabin_learn_to_dance_clip2
120,recording_20210921_S10_S11_02,2133,2723,590,0 male,cabin_learn_to_dance_clip3
121,recording_20210921_S10_S11_02,2723,3255,532,0 male,cabin_learn_to_dance_clip4
122,recording_20210921_S10_S11_02,3255,3790,535,0 male,cabin_learn_to_dance_clip5
123,recording_20210921_S05_S12_01,1331,1670,339,0 female,cabin_walk_in _and_then_sit_on_bench_casual_chat_clip1
124,recording_20210921_S05_S12_01,1670,1935,265,0 female,cabin_stand_up_and_then_listen_clip1
125,recording_20210921_S05_S12_01,1935,2485,550,0 female,cabin_stand_casual_chat_clip2
126,recording_20210921_S05_S12_01,2485,2964,479,0 female,cabin_stand_casual_chat_clip3
127,recording_20210921_S05_S12_01,2964,3230,266,0 female,cabin_sit_on_bench_casual_chat_clip7
128,recording_20210921_S05_S12_02,1561,1718,157,0 female,cabin_lie_on_bench_clip1
129,recording_20210921_S05_S12_02,1718,1917,199,0 female,cabin_stand_up_from_lying_on_bench_clip1
130,recording_20210921_S05_S12_02,1917,2270,353,0 female,cabin_kneeling_on_bench_clip1
131,recording_20210921_S05_S12_03,3031,3278,247,0 female,cabin_sit_down_casual_chat_clip1
132,recording_20210921_S05_S12_03,3278,3548,270,0 female,cabin_switch_sitting_pose_clip1
133,recording_20210921_S05_S12_03,3548,3680,132,0 female,cabin_kneeling_on_bench_clip2
134,recording_20210923_S05_S13_01,1127,1502,375,0 female,lounge_stand_casual_chat_clip1
135,recording_20210923_S05_S13_01,1502,2001,499,0 female,lounge_lean_against_table_casual_chat_clip1
136,recording_20210923_S05_S13_01,2003,2578,575,0 female,lounge_lean_against_table_casual_chat_clip2
137,recording_20210923_S05_S13_01,2578,3031,453,0 female,lounge_lean_against_table_casual_chat_clip3
138,recording_20210923_S05_S13_01,3031,3385,354,0 female,lounge_sit_down_at_table_casual_chat_clip1
139,recording_20210923_S05_S13_01,3385,3553,168,0 female,lounge_stand_up_and_lean_against_table_clip1
140,recording_20210923_S05_S13_01,3553,3669,116,0 female,lounge_sit_down_at_table_casual_chat_clip2
141,recording_20210923_S05_S13_01,3669,3977,308,0 female,lounge_sit_at_table_casual_chat_clip1
142,recording_20210923_S05_S13_01,3977,4157,180,0 female,lounge_stand_up_and_lean_against_table_clip2
143,recording_20210923_S05_S13_01,4157,4399,242,0 female,lounge_lean_against_table_casual_chat_clip4
144,recording_20210923_S13_S05_01,951,1233,282,0 female,lounge_walk_around_table_casual_chat_clip1
145,recording_20210923_S13_S05_01,1233,1351,118,0 female,lounge_sit_down_at_table_casual_chat_clip3
146,recording_20210923_S13_S05_01,1351,1449,98,0 female,lounge_sit_at_table_casual_chat_clip2
147,recording_20210923_S13_S05_01,1449,1568,119,0 female,lounge_stand_up_clip1
148,recording_20210923_S13_S05_01,1568,1923,355,0 female,lounge_walk_around_table_casual_chat_clip2
149,recording_20210923_S13_S05_01,1923,2249,326,0 female,lounge_lean_against_table_casual_chat_clip5
150,recording_20210923_S13_S05_01,2249,2359,110,0 female,lounge_sit_down_at_table_casual_chat_clip4
151,recording_20210923_S13_S05_01,2359,2493,134,0 female,lounge_stand_up_clip2
152,recording_20210923_S13_S05_01,2493,2934,441,0 female,lounge_walk_around_table_casual_chat_clip3
153,recording_20210923_S13_S05_01,2934,3095,161,0 female,lounge_sit_down_at_table_casual_chat_clip5
154,recording_20210923_S13_S05_01,3095,3177,82,0 female,lounge_sit_at_table_casual_chat_clip3
155,recording_20210923_S13_S05_01,3177,3277,100,0 female,lounge_stand_up_casual_chat_clip1
156,recording_20210923_S13_S05_01,3277,3850,573,0 female,lounge_walk_around_table_casual_chat_clip4
157,recording_20210923_S05_S13_02,3801,4340,539,0 female,lounge_stand_casual_chat_clip2
158,recording_20210923_S14_S03_01,841,991,150,0 female,lounge_sit_down_at_table_casual_chat_clip6
159,recording_20210923_S14_S03_01,991,1418,427,0 female,lounge_sit_at_table_casual_chat_clip4
160,recording_20210923_S14_S03_01,1418,1569,151,0 female,lounge_stand_up_casual_chat_clip2
161,recording_20210923_S14_S03_01,1569,1850,281,0 female,lounge_stand_casual_chat_clip3
162,recording_20210923_S14_S03_01,1850,2450,600,0 female,lounge_walk_around_table_casual_chat_clip5
163,recording_20210923_S14_S03_01,2450,2850,400,0 female,lounge_wander_around_table_casual_chat_clip1
164,recording_20210923_S14_S03_01,2850,3250,400,0 female,lounge_wander_around_table_casual_chat_clip2
165,recording_20210923_S03_S14_01,1211,1732,521,0 female,draw_with_hands_clip1
166,recording_20210923_S03_S14_01,1732,2355,623,0 female,draw_with_hands_clip2
167,recording_20210923_S03_S14_01,2355,2856,501,0 female,draw_with_hands_clip3
168,recording_20210923_S03_S14_01,2856,3250,394,0 female,draw_with_hands_clip4
169,recording_20210923_S14_S03_02,1101,1388,287,0 female,push_out_clip1
170,recording_20210923_S14_S03_02,1388,1591,203,0 female,punch_clip1
171,recording_20210923_S14_S03_02,1591,2042,451,0 female,play_badminton_clip1
172,recording_20210923_S14_S03_03,2201,2710,509,0 female,studnet_attend_class_clip1
173,recording_20210929_S15_S11_01,1461,1961,500,0 female,teacher_teach_courses_clip1
174,recording_20210929_S15_S11_01,1961,2461,500,0 female,teacher_teach_courses_clip2
175,recording_20210929_S15_S11_01,2461,2961,500,0 female,teacher_teach_courses_clip3
176,recording_20210929_S15_S11_01,2961,3461,500,0 female,teacher_teach_courses_clip4
177,recording_20210929_S15_S11_01,3461,3990,529,0 female,teacher_teach_courses_clip5
178,recording_20210929_S15_S11_02,4011,4422,411,0 female,teacher_teach_courses_clip6
179,recording_20210929_S15_S11_02,4422,4920,498,0 female,teacher_teach_courses_clip7
180,recording_20210929_S15_S11_03,881,1422,541,0 female,catch_toss_pick_up_pen_clip6
181,recording_20210929_S15_S11_03,1422,1922,500,0 female,catch_toss_pick_up_pen_clip7
182,recording_20210929_S15_S11_03,1922,2423,501,0 female,catch_toss_pick_up_pen_clip8
183,recording_20210929_S15_S11_03,2423,3010,587,0 female,catch_toss_pick_up_pen_clip9
184,recording_20210929_S05_S16_01,881,1422,541,0 female,discuss_with_others_clip1
185,recording_20210929_S05_S16_01,1422,1933,511,0 female,discuss_with_others_clip2
186,recording_20210929_S05_S16_01,1933,2488,555,0 female,discuss_with_others_clip3
187,recording_20210929_S05_S16_01,2488,3056,568,0 female,discuss_with_others_clip4
188,recording_20210929_S05_S16_01,3056,3633,577,0 female,discuss_with_others_clip5
189,recording_20210929_S05_S16_01,3633,4270,637,0 female,discuss_with_others_clip6
190,recording_20210929_S16_S05_01,1171,1655,484,0 female,discuss_with_others_clip7
191,recording_20210929_S16_S05_01,1655,2137,482,0 female,discuss_with_others_clip8
192,recording_20210929_S16_S05_01,2137,2655,518,0 female,discuss_with_others_clip9
193,recording_20210929_S16_S05_01,2655,3177,522,0 female,discuss_with_others_clip10
194,recording_20210929_S16_S05_01,3177,3688,511,0 female,discuss_with_others_clip11
195,recording_20210929_S16_S05_01,3688,4200,512,0 female,discuss_with_others_clip12
196,recording_20210929_S16_S05_01,4200,4650,450,0 female,discuss_with_others_clip13
197,recording_20210929_S16_S05_01,4650,5100,450,0 female,discuss_with_others_clip14
198,recording_20210929_S05_S16_02,1301,1801,500,0 female,casual_chat_clip1
199,recording_20210929_S05_S16_02,1801,2301,500,0 female,casual_chat_clip2
200,recording_20210929_S05_S16_02,2301,2801,500,0 female,casual_chat_clip3
201,recording_20210929_S05_S16_02,2801,3330,529,0 female,casual_chat_clip4
202,recording_20210929_S05_S16_03,751,1063,312,0 female,instruct_to_act_clip1
203,recording_20210929_S05_S16_03,1063,1400,337,0 female,instruct_to_act_clip2
204,recording_20210929_S05_S16_04,2351,2880,529,0 female,instruct_to_act_clip3
205,recording_20211002_S15_S17_01,1961,2533,572,0 male,casual_chat_clip5
206,recording_20211002_S15_S17_01,2533,3033,500,0 male,casual_chat_clip6
207,recording_20211002_S15_S17_01,3033,3533,500,0 male,casual_chat_clip7
208,recording_20211002_S15_S17_01,3533,4033,500,0 male,casual_chat_clip8
209,recording_20211002_S15_S17_01,4033,4530,497,0 male,casual_chat_clip9
210,recording_20211002_S17_S15_01,1321,1854,533,0 male,casual_chat_clip10
211,recording_20211002_S17_S15_01,1854,2433,579,0 male,casual_chat_clip11
212,recording_20211002_S17_S15_01,2433,2933,500,0 male,casual_chat_clip12
213,recording_20211002_S17_S15_01,2933,3500,567,0 male,casual_chat_clip13
214,recording_20211002_S17_S15_01,3500,4080,580,0 male,casual_chat_clip14
215,recording_20211002_S15_S17_02,1121,1621,500,0 male,casual_chat_clip15
216,recording_20211002_S15_S17_02,1621,2121,500,0 male,casual_chat_clip16
217,recording_20211002_S15_S17_02,2121,2621,500,0 male,casual_chat_clip17
218,recording_20211002_S15_S17_02,2621,3152,531,0 male,casual_chat_clip18
219,recording_20211002_S15_S17_02,3121,3740,619,0 male,casual_chat_clip19
220,recording_20211002_S17_S15_02,1141,1500,359,0 male,learn_to_work_out_clip1
221,recording_20211002_S17_S15_03,2141,2543,402,0 male,learn_to_work_out_clip2
222,recording_20211002_S17_S15_03,2543,2920,377,0 male,learn_to_work_out_clip3
223,recording_20211002_S03_S18_01,2301,2847,546,0 male,casual_chat_clip20
224,recording_20211002_S03_S18_01,2847,3440,593,0 male,casual_chat_clip21
225,recording_20211002_S03_S18_02,3811,4322,511,0 male,casual_chat_clip22
226,recording_20211002_S03_S18_02,4322,4711,389,0 male,casual_chat_clip23
227,recording_20211002_S03_S18_02,4711,5110,399,0 male,casual_chat_clip24
228,recording_20211002_S03_S18_03,1851,2263,412,0 female,casual_chat_clip25
229,recording_20211002_S03_S18_03,2263,2618,355,0 female,casual_chat_clip26
230,recording_20211002_S03_S18_03,2618,3000,382,0 female,learn_to_toss_clip1
231,recording_20211002_S03_S18_03,3000,3510,510,0 female,learn_to_toss_clip2
232,recording_20211002_S03_S18_04,3601,4101,500,0 female,learn_to_work_out_clip4
233,recording_20211002_S03_S18_04,4101,4601,500,0 female,learn_to_work_out_clip5
234,recording_20211002_S03_S18_04,4601,5051,450,0 female,learn_to_work_out_clip6
235,recording_20211002_S03_S18_04,5051,5450,399,0 female,learn_to_work_out_clip7
236,recording_20211002_S18_S03_01,1441,1860,419,0 female,casual_chat_clip27
237,recording_20211002_S18_S03_02,2601,2960,359,0 female,casual_chat_clip28
238,recording_20211004_S19_S06_01,1601,2101,500,0 male,discuss_with_others_clip15
239,recording_20211004_S19_S06_01,2101,2601,500,0 male,discuss_with_others_clip16
240,recording_20211004_S19_S06_01,2601,3101,500,0 male,discuss_with_others_clip17
241,recording_20211004_S19_S06_01,3101,3601,500,0 male,discuss_with_others_clip18
242,recording_20211004_S19_S06_01,3601,4101,500,0 male,discuss_with_others_clip19
243,recording_20211004_S19_S06_01,4101,4670,569,0 male,discuss_with_others_clip20
244,recording_20211004_S19_S06_02,1711,2211,500,0 male,discuss_with_others_clip21
245,recording_20211004_S19_S06_02,2211,2711,500,0 male,discuss_with_others_clip22
246,recording_20211004_S19_S06_02,2711,3211,500,0 male,discuss_with_others_clip23
247,recording_20211004_S19_S06_02,3211,3530,319,0 male,discuss_with_others_clip24
248,recording_20211004_S19_S06_03,3781,4190,409,0 male,discuss_with_others_clip25
249,recording_20211004_S19_S06_04,1071,1571,500,0 male,stretch_clip1
250,recording_20211004_S19_S06_04,1571,2075,504,0 male,stretch_clip2
251,recording_20211004_S19_S06_04,2075,2533,458,0 male,casual_chat_clip29
252,recording_20211004_S19_S06_04,2533,2950,417,0 male,casual_chat_clip30
253,recording_20211004_S19_S06_05,3051,3394,343,0 male,casual_chat_clip31
254,recording_20211004_S19_S06_05,3394,3760,366,0 male,casual_chat_stretch_clip1
255,recording_20211004_S12_S20_01,1141,1641,500,0 female,casual_chat_clip32
256,recording_20211004_S12_S20_01,1641,2141,500,0 female,casual_chat_clip33
257,recording_20211004_S12_S20_01,2141,2641,500,0 female,casual_chat_clip34
258,recording_20211004_S12_S20_01,2641,3141,500,0 female,casual_chat_clip35
259,recording_20211004_S12_S20_01,3141,3541,400,0 female,casual_chat_clip36
260,recording_20211004_S12_S20_01,3541,3970,429,0 female,casual_chat_clip37
261,recording_20211004_S20_S12_01,1351,1935,584,0 female,teacher_teach_courses_clip8
262,recording_20211004_S20_S12_01,1935,2535,600,0 female,teacher_teach_courses_clip9
263,recording_20211004_S20_S12_01,2535,3135,600,0 female,teacher_teach_courses_clip10
264,recording_20211004_S20_S12_01,3135,3635,500,0 female,teacher_teach_courses_clip11
265,recording_20211004_S20_S12_01,3635,4180,545,0 female,teacher_teach_courses_clip12
266,recording_20211004_S12_S20_02,1131,1567,436,0 female,studnet_attend_class_clip2
267,recording_20211004_S12_S20_02,1567,2022,455,0 female,studnet_attend_class_clip3
268,recording_20211004_S12_S20_02,2022,2420,398,0 female,studnet_attend_class_clip4
269,recording_20211004_S20_S12_02,921,1251,330,0 female,pass_phone_clip1
270,recording_20211004_S20_S12_02,1251,1587,336,0 female,casual_chat_clip38
271,recording_20211004_S20_S12_02,1587,1970,383,0 female,casual_chat_clip39
272,recording_20211004_S12_S20_03,951,1476,525,0 female,casual_chat_clip40
273,recording_20211004_S12_S20_03,1476,1706,230,0 female,learn_swim_clip1
274,recording_20211004_S12_S20_03,1706,2260,554,0 female,learn_ride_motorcycle_clip1
275,recording_20211004_S12_S20_03,2260,2655,395,0 female,casual_chat_clip41
276,recording_20211004_S12_S20_03,2655,3020,365,0 female,casual_chat_clip42
277,recording_20211004_S12_S20_04,3111,3650,539,0 female,casual_chat_clip43
278,recording_20211004_S20_S12_03,901,1350,449,0 female,learn_ride_motorcycle_clip2
279,recording_20211004_S20_S12_03,1350,1890,540,0 female,learn_ride_motorcycle_clip3
280,recording_20211004_S20_S12_04,1981,2435,454,0 female,learn_to_toss_clip3
281,recording_20211004_S20_S12_04,2435,2821,386,0 female,learn_fighting_clip1
282,recording_20211004_S20_S12_04,2821,3321,500,0 female,learn_to_toss_clip4
283,recording_20211004_S20_S12_04,3321,3719,398,0 female,learn_to_toss_clip5
284,recording_20211004_S20_S12_04,3719,4130,411,0 female,learn_fencing_clip1
285,recording_20220215_S21_S22_01,1901,2401,500,0 male,catch_toss_pick_up_clip1
286,recording_20220215_S21_S22_01,2401,2901,500,0 male,catch_toss_pick_up_clip2
287,recording_20220215_S21_S22_01,2901,3401,500,0 male,catch_toss_pick_up_clip3
288,recording_20220215_S21_S22_01,3401,3901,500,0 male,catch_toss_pick_up_clip4
289,recording_20220215_S21_S22_01,3901,4401,500,0 male,catch_toss_pick_up_clip5
290,recording_20220215_S21_S22_01,4401,4900,499,0 male,catch_toss_pick_up_clip6
291,recording_20220215_S22_S21_01,1541,2041,500,0 male,catch_toss_pick_up_clip7
292,recording_20220215_S22_S21_01,2041,2541,500,0 male,catch_toss_pick_up_clip8
293,recording_20220215_S22_S21_01,2541,3041,500,0 male,catch_toss_pick_up_clip9
294,recording_20220215_S22_S21_01,3041,3441,400,0 male,catch_toss_pick_up_clip10
295,recording_20220215_S22_S21_01,3441,3870,429,0 male,catch_toss_pick_up_clip11
296,recording_20220215_S22_S21_02,1411,1801,390,0 male,stand_casual_chat_clip25
297,recording_20220215_S22_S21_02,1801,2166,365,0 male,pass_tape_clip1
298,recording_20220215_S22_S21_02,2166,2666,500,0 male,pass_and_take_tape_clip1
299,recording_20220215_S22_S21_02,2666,3166,500,0 male,pass_and_take_tape_clip2
300,recording_20220215_S22_S21_02,3166,3522,356,0 male,pass_and_take_tape_clip3
301,recording_20220215_S22_S21_02,3522,3950,428,0 male,pass_and_take_tape_clip4
302,recording_20220215_S22_S21_03,1221,1721,500,0 male,teach_TaiChi_clip1
303,recording_20220215_S22_S21_03,1721,2150,429,0 male,teach_TaiChi_clip2
304,recording_20220215_S21_S22_02,1511,2011,500,0 male,draw_with_hands_clip5
305,recording_20220215_S21_S22_02,2011,2511,500,0 male,draw_with_hands_clip6
306,recording_20220215_S21_S22_02,2511,3011,500,0 male,draw_with_hands_clip7
307,recording_20220215_S21_S22_02,3011,3511,500,0 male,draw_with_hands_clip8
308,recording_20220215_S21_S22_02,3511,4111,600,0 male,draw_with_hands_clip9
309,recording_20220215_S21_S22_02,4111,4750,639,0 male,draw_with_hands_clip10
310,recording_20220215_S22_S21_04,1461,1961,500,0 male,perform_eat_clip1
311,recording_20220215_S22_S21_04,1961,2429,468,0 male,perform_drink_clip1
312,recording_20220215_S22_S21_04,2429,2945,516,0 male,perform_eat_clip2
313,recording_20220215_S22_S21_04,2945,3545,600,0 male,draw_with_hands_guess_clip1
314,recording_20220215_S22_S21_04,3545,4044,499,0 male,draw_with_hands_guess_clip2
315,recording_20220215_S22_S21_04,4044,4630,586,0 male,draw_with_hands_guess_clip3
316,recording_20220218_S23_S02_01,1551,2051,500,0 female,learn_to_dance_clip1
317,recording_20220218_S23_S02_01,2051,2551,500,0 female,learn_to_dance_clip2
318,recording_20220218_S23_S02_01,2551,3051,500,0 female,learn_to_dance_clip3
319,recording_20220218_S23_S02_01,3051,3551,500,0 female,learn_to_dance_clip4
320,recording_20220218_S23_S02_01,3551,3950,399,0 female,learn_to_dance_clip5
321,recording_20220218_S02_S23_01,2091,2591,500,0 female,dance_clip1
322,recording_20220218_S02_S23_01,2591,3091,500,0 female,dance_clip2
323,recording_20220218_S02_S23_01,3091,3591,500,0 female,dance_clip3
324,recording_20220218_S02_S23_01,3591,4090,499,0 female,dance_clip4
325,recording_20220218_S23_S02_02,1301,1801,500,0 female,stretch_dance_clip1
326,recording_20220218_S23_S02_02,1801,2301,500,0 female,stretch_dance_clip2
327,recording_20220218_S23_S02_02,2301,2801,500,0 female,stretch_dance_clip3
328,recording_20220218_S23_S02_02,2801,3301,500,0 female,stretch_dance_clip4
329,recording_20220218_S23_S02_02,3301,3700,399,0 female,stretch_dance_clip5
330,recording_20220218_S02_S23_02,2551,3051,500,0 female,dance_relax_clip1
331,recording_20220218_S02_S23_02,3051,3551,500,0 female,dance_relax_clip2
332,recording_20220218_S02_S23_02,3551,4051,500,0 female,dance_relax_clip3
333,recording_20220218_S02_S23_02,4051,4551,500,0 female,dance_relax_clip4
334,recording_20220218_S02_S23_02,4551,4950,399,0 female,dance_relax_clip5
335,recording_20220225_S24_S25_01,1901,2401,500,0 female,stand_casual_chat_clip26
336,recording_20220225_S24_S25_01,2401,2901,500,0 female,stand_casual_chat_clip27
337,recording_20220225_S24_S25_01,2901,3450,549,0 female,stand_casual_chat_clip28
338,recording_20220225_S24_S25_01,3450,4030,580,0 female,stand_casual_chat_clip29
339,recording_20220225_S25_S24_01,2441,2684,243,0 female,stretch_clip3
340,recording_20220225_S25_S24_01,2684,3184,500,0 female,learn_to_dance_clip6
341,recording_20220225_S25_S24_01,3184,3684,500,0 female,learn_to_dance_clip7
342,recording_20220225_S25_S24_01,3684,4240,556,0 female,learn_to_dance_clip8
343,recording_20220225_S24_S25_02,3031,3401,370,0 female,dance_clip5
344,recording_20220225_S24_S25_02,3401,3970,569,0 female,dance_clip6
345,recording_20220225_S26_S27_01,1901,2450,549,0 male,casual_chat_clip44
346,recording_20220225_S26_S27_01,2450,2950,500,0 male,casual_chat_clip45
347,recording_20220225_S26_S27_01,2950,3450,500,0 male,casual_chat_clip46
348,recording_20220225_S26_S27_01,3450,3850,400,0 male,casual_chat_clip47
349,recording_20220225_S26_S27_01,3850,4230,380,0 male,casual_chat_clip48
350,recording_20220225_S27_S26_01,2201,2601,400,0 male,stretch_clip4
351,recording_20220225_S27_S26_01,2601,3001,400,0 male,stretch_clip5
352,recording_20220225_S27_S26_01,3001,3550,549,0 male,stretch_clip6
353,recording_20220225_S27_S26_02,3571,3871,300,0 male,stretch_clip7
354,recording_20220225_S27_S26_02,3871,4250,379,0 male,stretch_clip8
355,recording_20220225_S27_S26_03,1670,1978,308,0 male,take_tape_clip1
356,recording_20220225_S27_S26_03,1978,2578,600,0 male,casual_chat_clip49
357,recording_20220225_S27_S26_03,2578,2878,300,0 male,casual_chat_clip50
358,recording_20220225_S27_S26_03,2878,3239,361,0 male,casual_chat_clip51
359,recording_20220225_S27_S26_04,3401,3701,300,0 male,casual_chat_clip52
360,recording_20220225_S27_S26_04,3701,4060,359,0 male,casual_chat_clip53
361,recording_20220312_S28_S29_01,1661,2161,500,0 female,casual_chat_clip54
362,recording_20220312_S28_S29_01,2161,2661,500,0 female,casual_chat_clip55
363,recording_20220312_S28_S29_01,2661,3153,492,0 female,casual_chat_clip56
364,recording_20220312_S28_S29_01,3153,3310,157,0 female,pass_card_clip1
365,recording_20220312_S28_S29_01,3310,3574,264,0 female,casual_chat_clip57
366,recording_20220312_S28_S29_01,3574,3974,400,0 female,take_check_card_clip1
367,recording_20220312_S28_S29_01,3974,4300,326,0 female,take_check_card_clip2
368,recording_20220312_S28_S29_01,4300,4790,490,0 female,take_check_card_clip3
369,recording_20220312_S29_S28_01,1501,2001,500,0 female,catch_toss_pick_up_pen_clip10
370,recording_20220312_S29_S28_01,2001,2501,500,0 female,catch_toss_pick_up_pen_clip11
371,recording_20220312_S29_S28_01,2501,3001,500,0 female,catch_toss_pick_up_pen_clip12
372,recording_20220312_S29_S28_01,3001,3501,500,0 female,catch_toss_pick_up_pen_clip13
373,recording_20220312_S29_S28_01,3501,4001,500,0 female,catch_toss_pick_up_pen_clip14
374,recording_20220312_S29_S28_01,4001,4501,500,0 female,catch_toss_pick_up_pen_clip15
375,recording_20220312_S29_S28_01,4501,4960,459,0 female,catch_toss_pick_up_pen_clip16
376,recording_20220312_S28_S29_02,1401,1901,500,0 male,catch_toss_pick_up_clip12
377,recording_20220312_S28_S29_02,1901,2401,500,0 male,catch_toss_pick_up_clip13
378,recording_20220312_S28_S29_02,2401,2901,500,0 male,catch_toss_pick_up_clip14
379,recording_20220312_S28_S29_02,2901,3401,500,0 male,catch_toss_pick_up_clip15
380,recording_20220312_S28_S29_02,3401,3950,549,0 male,catch_toss_pick_up_clip16
381,recording_20220312_S29_S28_02,1401,2000,599,0 male,stand_casual_chat_clip30
382,recording_20220312_S29_S28_03,2221,2805,584,0 male,stand_casual_chat_clip31
383,recording_20220312_S29_S28_03,2805,3082,277,0 male,teach_ski_clip1
384,recording_20220312_S29_S28_03,3082,3322,240,0 male,stand_casual_chat_clip32
385,recording_20220312_S29_S28_03,3553,3786,233,0 male,snap_fingers_clip1
386,recording_20220312_S29_S28_03,3786,4340,554,0 male,teach_boat_clip1
387,recording_20220312_S29_S28_04,4561,5070,509,0 male,perform_drink_instant_coffee_clip1
388,recording_20220312_S28_S29_03,1301,1860,559,0 female,instruct_to_ride_bike_clip1
389,recording_20220312_S28_S29_04,2021,2378,357,0 female,teach_dance_clip3
390,recording_20220312_S28_S29_04,2378,2792,414,0 female,teach_dance_clip4
391,recording_20220312_S28_S29_04,2792,3248,456,0 female,teach_skate_clip1
392,recording_20220312_S28_S29_04,3248,3360,112,0 female,teach_ballet_clip1
393,recording_20220312_S28_S29_05,3511,3850,339,0 female,teach_dance_clip5
394,recording_20220312_S29_S28_05,1411,1968,557,0 male,teach_TaiChi_clip3
395,recording_20220312_S29_S28_05,1968,2468,500,0 male,teach_TaiChi_clip4
396,recording_20220312_S29_S28_05,2468,2968,500,0 male,teach_TaiChi_clip5
397,recording_20220312_S29_S28_05,2968,3568,600,0 male,teach_TaiChi_clip6
398,recording_20220312_S29_S28_05,3568,4160,592,0 male,teach_TaiChi_clip7
399,recording_20220312_S28_S29_06,2051,2551,500,0 female,teach_TaiChi_clip8
400,recording_20220312_S28_S29_06,2551,3051,500,0 female,teach_TaiChi_clip9
401,recording_20220312_S28_S29_06,3051,3551,500,0 female,teach_TaiChi_clip10
402,recording_20220312_S28_S29_06,3551,4051,500,0 female,teach_TaiChi_clip11
403,recording_20220312_S28_S29_06,4051,4600,549,0 female,teach_TaiChi_clip12
404,recording_20220315_S21_S30_01,2571,3071,500,0 female,casual_chat_clip58
405,recording_20220315_S21_S30_01,3071,3571,500,0 female,casual_chat_clip59
406,recording_20220315_S21_S30_01,3571,4100,529,0 female,casual_chat_clip60
407,recording_20220315_S21_S30_01,4100,4690,590,0 female,casual_chat_clip61
408,recording_20220315_S30_S21_01,1401,1845,444,0 female,run_clip1
409,recording_20220315_S30_S21_01,1845,2184,339,0 female,squat up_clip1
410,recording_20220315_S30_S21_01,2184,2621,437,0 female,stretch_clip9
411,recording_20220315_S30_S21_01,2621,2962,341,0 female,jump_jack_clip1
412,recording_20220315_S30_S21_01,2962,3134,172,0 female,take_water_clip1
413,recording_20220315_S30_S21_01,3134,3686,552,0 female,casual_chat_clip62
414,recording_20220315_S30_S21_01,3686,3940,254,0 female,kick_up_clip1
415,recording_20220315_S21_S30_02,1501,1667,166,0 female,dance_clip7
416,recording_20220315_S21_S30_02,1667,1879,212,0 female,bow_clip1
417,recording_20220315_S21_S30_02,1879,2379,500,0 female,learn_TaiChi_clip1
418,recording_20220315_S21_S30_02,2379,2890,511,0 female,learn_TaiChi_clip2
419,recording_20220315_S21_S30_03,3161,3650,489,0 female,learn_TaiChi_clip3
420,recording_20220315_S21_S30_03,3650,4100,450,0 female,learn_TaiChi_clip4
421,recording_20220315_S21_S30_04,4131,4670,539,0 female,learn_TaiChi_clip5
422,recording_20220315_S30_S21_02,1031,1531,500,0 female,learn_TaiChi_clip6
423,recording_20220315_S30_S21_02,1531,2031,500,0 female,learn_TaiChi_clip7
424,recording_20220315_S30_S21_02,2031,2531,500,0 female,learn_TaiChi_clip8
425,recording_20220315_S30_S21_02,2531,3031,500,0 female,learn_TaiChi_clip9
426,recording_20220315_S30_S21_02,3031,3531,500,0 female,learn_TaiChi_clip10
427,recording_20220315_S30_S21_02,3531,4130,599,0 female,learn_TaiChi_clip11
428,recording_20220315_S21_S30_05,1301,1762,461,0 female,jump_jack_clip2
429,recording_20220315_S21_S30_05,1762,2314,552,0 female,kick_up_clip2
430,recording_20220315_S21_S30_05,2314,2614,300,0 female,dance_clip8
431,recording_20220315_S21_S30_05,2614,3000,386,0 female,dance_clip9
432,recording_20220315_S21_S30_06,3181,3581,400,0 female,dance_clip10
433,recording_20220315_S21_S30_06,3581,3990,409,0 female,dance_clip11
434,recording_20220318_S31_S32_01,1810,2310,500,0 female,casual_chat_clip63
435,recording_20220318_S31_S32_01,2310,2810,500,0 female,casual_chat_clip64
436,recording_20220318_S31_S32_01,2810,3310,500,0 female,casual_chat_clip65
437,recording_20220318_S31_S32_01,3310,3610,300,0 female,casual_chat_clip66
438,recording_20220318_S31_S32_01,3610,4110,500,0 female,casual_chat_clip67
439,recording_20220318_S31_S32_01,4110,4560,450,0 female,casual_chat_clip68
440,recording_20220318_S32_S31_01,1626,2000,374,0 female,casual_chat_clip69
441,recording_20220318_S32_S31_01,2000,2541,541,0 female,casual_chat_clip70
442,recording_20220318_S32_S31_01,2541,2941,400,0 female,stand_listen_clip1
443,recording_20220318_S32_S31_01,2941,3341,400,0 female,stand_listen_clip2
444,recording_20220318_S32_S31_01,3341,3741,400,0 female,stand_listen_clip3
445,recording_20220318_S32_S31_01,3741,4279,538,0 female,stand_listen_clip4
446,recording_20220318_S32_S31_01,4279,4875,596,0 female,casual_chat_clip71
447,recording_20220318_S32_S31_02,1621,2121,500,0 female,perform_animals_clip1
448,recording_20220318_S32_S31_02,2121,2621,500,0 female,perform_animals_clip2
449,recording_20220318_S32_S31_02,2621,3121,500,0 female,perform_animals_clip3
450,recording_20220318_S32_S31_02,3121,3421,300,0 female,perform_animals_clip4
451,recording_20220318_S32_S31_02,3421,3835,414,0 female,perform_animals_clip5
452,recording_20220318_S32_S31_02,3835,4115,280,0 female,perform_to_write_clip1
453,recording_20220318_S32_S31_02,4115,4380,265,0 female,casual_chat_clip72
454,recording_20220318_S34_S33_01,2151,2651,500,0 female,discuss_with_others_clip26
455,recording_20220318_S34_S33_01,2651,3160,509,0 female,discuss_with_others_clip27
456,recording_20220318_S34_S33_02,3501,4001,500,0 female,casual_chat_clip73
457,recording_20220318_S34_S33_02,4001,4550,549,0 female,casual_chat_clip74
458,recording_20220318_S34_S33_02,4550,5140,590,0 female,casual_chat_clip75
459,recording_20220318_S34_S33_03,1701,2201,500,0 female,discuss_with_others_clip28
460,recording_20220318_S34_S33_03,2201,2701,500,0 female,discuss_with_others_clip29
461,recording_20220318_S34_S33_03,2701,3201,500,0 female,discuss_with_others_clip30
462,recording_20220318_S34_S33_03,3201,3701,500,0 female,discuss_with_others_clip31
463,recording_20220318_S34_S33_03,3701,4101,400,0 female,discuss_with_others_clip32
464,recording_20220318_S34_S33_03,4101,4670,569,0 female,discuss_with_others_clip33
465,recording_20220318_S33_S34_01,2691,3190,499,0 male,discuss_with_others_clip34
466,recording_20220318_S33_S34_01,3190,3690,500,0 male,discuss_with_others_clip35
467,recording_20220318_S33_S34_01,3690,4190,500,0 male,discuss_with_others_clip36
468,recording_20220318_S33_S34_01,4190,4690,500,0 male,discuss_with_others_clip37
469,recording_20220318_S33_S34_01,4690,5150,460,0 male,discuss_with_others_clip38
470,recording_20220318_S33_S34_02,2001,2544,543,0 male,casual_chat_clip76
471,recording_20220318_S33_S34_02,2544,2930,386,0 male,arms_up_and_down_clip1
472,recording_20220318_S33_S34_02,2930,3226,296,0 male,squat_down_and_then_stand_up_clip1
473,recording_20220318_S33_S34_02,3226,3754,528,0 male,stretch_clip10
474,recording_20220318_S33_S34_02,3754,4316,562,0 male,casual_chat_clip77
475,recording_20220318_S33_S34_02,4316,4574,258,0 male,jump_jack_clip3
476,recording_20220415_S36_S35_01,1401,1901,500,0 male,discuss_about_book_clip1
477,recording_20220415_S36_S35_01,1901,2401,500,0 male,discuss_about_book_clip2
478,recording_20220415_S36_S35_01,2401,2901,500,0 male,discuss_about_book_clip3
479,recording_20220415_S36_S35_01,2901,3401,500,0 male,discuss_about_book_clip4
480,recording_20220415_S36_S35_01,3401,3950,549,0 male,discuss_about_book_clip5
481,recording_20220415_S36_S35_02,1801,2201,400,0 male,casual_chat_clip78
482,recording_20220415_S36_S35_02,2201,2601,400,0 male,casual_chat_clip79
483,recording_20220415_S36_S35_02,2601,3001,400,0 male,casual_chat_clip80
484,recording_20220415_S36_S35_02,3001,3501,500,0 male,casual_chat_clip81
485,recording_20220415_S36_S35_02,3501,4000,499,0 male,casual_chat_clip82
486,recording_20220415_S35_S36_01,951,1451,500,0 male,casual_chat_clip83
487,recording_20220415_S35_S36_01,1451,1951,500,0 male,casual_chat_clip84
488,recording_20220415_S35_S36_01,1951,2451,500,0 male,casual_chat_clip85
489,recording_20220415_S35_S36_01,2451,3050,599,0 male,casual_chat_clip86
490,recording_20220415_S35_S36_01,3050,3570,520,0 male,casual_chat_clip87
491,recording_20220415_S35_S36_02,1001,1501,500,0 male,instruct_to_act_clip4
492,recording_20220415_S35_S36_02,1501,2001,500,0 male,instruct_to_act_clip5
493,recording_20220415_S35_S36_02,2001,2501,500,0 male,instruct_to_act_clip6
494,recording_20220415_S35_S36_02,2501,3001,500,0 male,instruct_to_act_clip7
495,recording_20220415_S35_S36_02,3001,3480,479,0 male,instruct_to_act_clip8
496,recording_20210907_S02_S01_01,1551,2053,502,1 female,stand_casual_chat_clip33
497,recording_20210907_S02_S01_01,2053,2453,400,1 female,stand_casual_chat_clip34
498,recording_20210907_S02_S01_01,2453,2717,264,1 female,stretch_squat_yoga_clip2
499,recording_20210907_S02_S01_01,2717,2840,123,1 female,stand_casual_chat_clip35
500,recording_20210907_S03_S04_01,1421,1893,472,1 female,take_class_sit_down_clip2
501,recording_20210907_S03_S04_01,1893,2180,287,1 female,take_class_look_book_clip1
502,recording_20210907_S04_S03_01,2001,2569,568,1 male,take_class_teach_clip5
503,recording_20210907_S04_S03_01,2569,2940,371,1 male,take_class_listen_clip1
504,recording_20210907_S04_S03_02,1601,2101,500,1 male,take_class_listen_clip2
505,recording_20210907_S04_S03_02,2101,2750,649,1 male,take_class_listen_clip3
506,recording_20210910_S05_S06_01,1451,1712,261,1 female,stand_casual_chat_clip36
507,recording_20210910_S05_S06_01,1712,2100,388,1 female,sit_casual chat_clip10
508,recording_20210910_S05_S06_01,2100,2600,500,1 female,sit_casual chat_clip11
509,recording_20210910_S05_S06_01,2600,2926,326,1 female,sit_casual chat_clip12
510,recording_20210910_S05_S06_01,2926,3500,574,1 female,stand_casual_chat_clip37
511,recording_20210910_S05_S06_01,3500,3900,400,1 female,stand_casual_chat_clip38
512,recording_20210910_S05_S06_01,3900,4490,590,1 female,stand_casual_chat_clip39
513,recording_20210910_S06_S05_01,951,1246,295,1 male,sit_casual chat_clip13
514,recording_20210910_S06_S05_01,1246,1870,624,1 male,stand_casual_chat_clip40
515,recording_20210910_S06_S05_02,1661,2132,471,1 male,stand_casual_chat_clip41
516,recording_20210910_S06_S05_02,2132,2622,490,1 male,stand_casual_chat_clip42
517,recording_20210910_S06_S05_02,2622,3221,599,1 male,stand_casual_chat_clip43
518,recording_20210910_S06_S05_02,3221,3790,569,1 male,take_picture_clip1
519,recording_20210910_S06_S05_03,2251,2737,486,1 male,learn_dance_clip1
520,recording_20210910_S06_S05_03,2737,3180,443,1 male,learn_dance_clip2
521,recording_20210911_S06_S07_01,2261,2422,161,1 male,sit_down_clip2
522,recording_20210911_S06_S07_01,2422,2845,423,1 male,sit_casual chat_clip14
523,recording_20210911_S06_S07_01,2845,3203,358,1 male,sit_casual chat_clip15
524,recording_20210911_S06_S07_01,3203,3701,498,1 male,stand_casual_chat_clip44
525,recording_20210911_S06_S07_01,3701,4203,502,1 male,stand_casual_chat_clip45
526,recording_20210911_S06_S07_01,4203,4640,437,1 male,stand_casual_chat_clip46
527,recording_20210911_S06_S07_02,901,1403,502,1 male,catch_toss_pick_up_pen_clip17
528,recording_20210911_S06_S07_02,1403,1905,502,1 male,catch_toss_pick_up_pen_clip18
529,recording_20210911_S06_S07_02,1905,2445,540,1 male,catch_toss_pick_up_pen_clip19
530,recording_20210911_S06_S07_02,2445,2993,548,1 male,catch_toss_pick_up_pen_clip20
531,recording_20210911_S06_S07_02,2993,3590,597,1 male,catch_toss_pick_up_pen_clip21
532,recording_20210911_S07_S06_01,1101,1294,193,1 male,catch_pen_clip1
533,recording_20210911_S07_S06_01,1294,1762,468,1 male,stand_casual_chat_clip47
534,recording_20210911_S07_S06_01,1762,2352,590,1 male,stand_casual_chat_clip48
535,recording_20210911_S07_S06_01,2352,2843,491,1 male,stand_casual_chat_clip49
536,recording_20210911_S07_S06_01,2843,3230,387,1 male,stand_casual_chat_clip50
537,recording_20210911_S07_S06_02,901,1350,449,1 male,kick_pen_clip5
538,recording_20210911_S07_S06_02,1350,1800,450,1 male,kick_pen_clip6
539,recording_20210911_S07_S06_03,1861,2235,374,1 male,kick_pen_clip7
540,recording_20210911_S07_S06_03,2235,2600,365,1 male,kick_pen_clip8
541,recording_20210911_S08_S03_01,1541,2013,472,1 female,stand_casual_chat_clip51
542,recording_20210911_S08_S03_01,2013,2402,389,1 female,sit_casual chat_clip16
543,recording_20210911_S08_S03_01,2402,2820,418,1 female,sit_casual chat_clip17
544,recording_20210911_S08_S03_01,2820,3333,513,1 female,stand_casual_chat_clip52
545,recording_20210911_S08_S03_01,3333,3926,593,1 female,stand_casual_chat_clip53
546,recording_20210911_S08_S03_01,3926,4430,504,1 female,stand_casual_chat_clip54
547,recording_20210911_S08_S03_02,2101,2550,449,1 female,stand_casual_chat_clip55
548,recording_20210911_S08_S03_03,2681,2981,300,1 female,stand_casual_chat_clip56
549,recording_20210911_S08_S03_03,2981,3450,469,1 female,stand_casual_chat_clip57
550,recording_20210911_S03_S08_01,1401,1903,502,1 male,stand_casual_chat_clip58
551,recording_20210911_S03_S08_01,1903,2468,565,1 male,stand_casual_chat_clip59
552,recording_20210911_S03_S08_01,2468,2880,412,1 male,stand_casual_chat_clip60
553,recording_20210911_S03_S08_02,3061,3443,382,1 male,stand_casual_chat_clip61
554,recording_20210911_S03_S08_02,3443,3880,437,1 male,stand_casual_chat_clip62
555,recording_20210918_S05_S06_01,2241,2739,498,1 male,pantry_sit_on_sofa_casual chat_clip20
556,recording_20210918_S05_S06_01,2739,3274,535,1 male,pantry_sit_on_sofa_casual chat_clip21
557,recording_20210918_S05_S06_01,3274,3620,346,1 male,pantry_sit_on_sofa_casual chat_clip22
558,recording_20210918_S06_S05_01,1811,2050,239,1 female,pantry_get_drink_water_clip1
559,recording_20210918_S06_S05_01,2128,2646,518,1 female,pantry_sit_down_sofa_clip1
560,recording_20210918_S06_S05_01,2646,2785,139,1 female,pantry_walk_clip1
561,recording_20210918_S06_S05_01,2785,2960,175,1 female,pantry_fetch_put_glass_clip1
562,recording_20210918_S06_S05_01,2960,3100,140,1 female,pantry_sit_down_sofa_clip2
563,recording_20210918_S06_S05_02,3271,3870,599,1 female,pantry_sit_on_sofa_casual chat_clip23
564,recording_20210918_S05_S06_02,751,1288,537,1 male,pantry_stand_demostrate_coffee_machine_clip1
565,recording_20210918_S05_S06_02,1288,1778,490,1 male,pantry_stand_demostrate_coffee_machine_clip2
566,recording_20210918_S05_S06_02,1778,2283,505,1 male,pantry_stand_demostrate_coffee_machine_clip3
567,recording_20210918_S05_S06_02,2283,2865,582,1 male,pantry_stand_demostrate_coffee_machine_clip4
568,recording_20210918_S05_S06_02,2865,3133,268,1 male,pantry_sit_demostrate_coffee_machine_clip1
569,recording_20210918_S05_S06_02,3133,3641,508,1 male,pantry_sit_demostrate_coffee_machine_clip2
570,recording_20210918_S05_S06_02,3641,3990,349,1 male,pantry_stand_demostrate_coffee_machine_clip5
571,recording_20210918_S06_S05_03,851,1255,404,1 female,pantry_sit_on_sofa_casual chat_clip24
572,recording_20210918_S06_S05_03,1255,1480,225,1 female,pantry_stand_up_and_then_sit_on_sofa_casual chat_clip1
573,recording_20210918_S05_S06_03,1001,1503,502,1 male,pantry_stand_bungee_jumping_casual_chat_clip1
574,recording_20210918_S05_S06_03,1503,2035,532,1 male,pantry_stand_bungee_jumping_casual_chat_clip2
575,recording_20210918_S05_S06_03,2035,2478,443,1 male,pantry_stand_bungee_jumping_casual_chat_clip3
576,recording_20210918_S05_S06_03,2478,2910,432,1 male,pantry_stand_bungee_jumping_casual_chat_clip4
577,recording_20210918_S05_S06_04,3211,3437,226,1 male,pantry_stretch_stand_casual_chat_clip1
578,recording_20210918_S05_S06_04,3437,4090,653,1 male,pantry_play_pingpong_casual_chat_clip1
579,recording_20210918_S05_S06_05,901,1401,500,1 male,pantry_walk_around_casual_chat_clip1
580,recording_20210918_S05_S06_05,1401,1901,500,1 male,pantry_walk_around_casual_chat_clip2
581,recording_20210918_S05_S06_05,1901,2401,500,1 male,pantry_walk_around_casual_chat_clip3
582,recording_20210918_S05_S06_05,2401,2901,500,1 male,pantry_walk_around_casual_chat_clip4
583,recording_20210918_S05_S06_05,2901,3401,500,1 male,pantry_walk_around_casual_chat_clip5
584,recording_20210918_S05_S06_05,3401,3990,589,1 male,pantry_walk_around_casual_chat_clip6
585,recording_20210918_S09_S05_01,1551,1867,316,1 female,pantry_sit_on_sofa_casual_chat_clip8
586,recording_20210918_S09_S05_01,1867,2145,278,1 female,pantry_stand_up_and_stand_casual_chat_clip1
587,recording_20210918_S09_S05_01,2145,2490,345,1 female,pantry_get_drink_water_and_hand_out_clip1
588,recording_20210918_S09_S05_02,3001,3165,164,1 female,pantry_sit_down_casual_chat_clip2
589,recording_20210918_S09_S05_02,3165,3755,590,1 female,pantry_sit_on_sofa_casual_chat_clip9
590,recording_20210918_S09_S05_02,3755,4218,463,1 female,pantry_sit_on_sofa_casual_chat_clip10
591,recording_20210918_S09_S05_02,4218,4450,232,1 female,pantry_stand_up_and_then_get_water_clip1
592,recording_20210918_S05_S09_01,1391,1800,409,1 female,pantry_sit_on_sofa_casual_chat_clip11
593,recording_20210918_S05_S09_01,1800,2295,495,1 female,pantry_sit_on_sofa_casual_chat_clip12
594,recording_20210918_S05_S09_01,2295,2950,655,1 female,pantry_stand_up_and_stand_casual_chat_clip2
595,recording_20210918_S09_S05_03,1721,2120,399,1 female,pantry_sit_on_sofa_casual chat_clip25
596,recording_20210918_S09_S05_03,2120,2520,400,1 female,pantry_sit_on_sofa_casual chat_clip26
597,recording_20210921_S10_S11_01,1171,1320,149,1 female,cabin_sit_down_casual_chat_clip2
598,recording_20210921_S10_S11_01,1320,1837,517,1 female,cabin_sit_on_bench_casual_chat_clip8
599,recording_20210921_S10_S11_01,1837,2355,518,1 female,cabin_sit_on_bench_casual_chat_clip9
600,recording_20210921_S10_S11_01,2355,2876,521,1 female,cabin_sit_on_bench_casual_chat_clip10
601,recording_20210921_S10_S11_01,2876,3360,484,1 female,cabin_sit_on_bench_casual_chat_clip11
602,recording_20210921_S11_S10_01,1111,1279,168,1 female,cabin_sit_down_casual_chat_clip3
603,recording_20210921_S11_S10_01,1279,1940,661,1 female,cabin_sit_on_bench_casual_chat_clip12
604,recording_20210921_S11_S10_02,2091,2543,452,1 female,cabin_sit_on_bench_listen_clip1
605,recording_20210921_S11_S10_02,2543,3033,490,1 female,cabin_sit_on_bench_listen_clip2
606,recording_20210921_S11_S10_02,3033,3475,442,1 female,cabin_sit_on_bench_listen_clip3
607,recording_20210921_S11_S10_02,3475,3870,395,1 female,cabin_sit_on_bench_listen_clip4
608,recording_20210921_S10_S11_02,1031,1622,591,1 female,cabin_instruct_to_dance_clip1
609,recording_20210921_S10_S11_02,1622,2133,511,1 female,cabin_instruct_to_dance_clip2
610,recording_20210921_S10_S11_02,2133,2723,590,1 female,cabin_instruct_to_dance_clip3
611,recording_20210921_S10_S11_02,2723,3255,532,1 female,cabin_instruct_to_dance_clip4
612,recording_20210921_S10_S11_02,3255,3790,535,1 female,cabin_instruct_to_dance_clip5
613,recording_20210921_S05_S12_01,1331,1601,270,1 female,cabin_walk_in _and_then_sit_on_bench_casual_chat_clip2
614,recording_20210921_S05_S12_01,1601,1781,180,1 female,cabin_stand_up_casual_chat_clip1
615,recording_20210921_S05_S12_01,1781,2393,612,1 female,cabin_stand_up_casual_chat_clip2
616,recording_20210921_S05_S12_01,2393,3000,607,1 female,cabin_stand_up_casual_chat_clip3
617,recording_20210921_S05_S12_01,3000,3230,230,1 female,cabin_sit_down_casual_chat_clip4
618,recording_20210921_S05_S12_02,1561,1996,435,1 female,cabin_stand_casual_chat_clip4
619,recording_20210921_S05_S12_02,1996,2162,166,1 female,cabin_sit_down_casual_chat_clip5
620,recording_20210921_S05_S12_02,2162,2270,108,1 female,cabin_stand_up_casual_chat_clip4
621,recording_20210921_S05_S12_03,3031,3390,359,1 female,cabin_sit_down_casual_chat_clip6
622,recording_20210921_S05_S12_03,3390,3640,250,1 female,cabin_stand_up_casual_chat_clip5
623,recording_20210923_S05_S13_01,1127,1628,501,1 female,lounge_walk_around_casual_chat_clip1
624,recording_20210923_S05_S13_01,1628,2021,393,1 female,lounge_stand_casual_chat_clip4
625,recording_20210923_S05_S13_01,2121,2638,517,1 female,lounge_stand_casual_chat_clip5
626,recording_20210923_S05_S13_01,2638,3037,399,1 female,lounge_stand_casual_chat_clip6
627,recording_20210923_S05_S13_01,3037,3254,217,1 female,lounge_sit_down_casual_chat_clip1
628,recording_20210923_S05_S13_01,3254,3444,190,1 female,lounge_sit_casual_chat_clip1
629,recording_20210923_S05_S13_01,3444,3672,228,1 female,lounge_stand_up_casual_chat_clip3
630,recording_20210923_S05_S13_01,3672,4000,328,1 female,lounge_stand_casual_chat_clip7
631,recording_20210923_S05_S13_01,4000,4399,399,1 female,lounge_stand_casual_chat_clip8
632,recording_20210923_S13_S05_01,951,1425,474,1 female,lounge_walk_around_table_casual_chat_clip6
633,recording_20210923_S13_S05_01,1425,1540,115,1 female,lounge_stand_casual_chat_clip9
634,recording_20210923_S13_S05_01,1540,2020,480,1 female,lounge_walk_around_table_casual_chat_clip7
635,recording_20210923_S13_S05_01,2020,2175,155,1 female,lounge_sit_down_casual_chat_clip2
636,recording_20210923_S13_S05_01,2175,2399,224,1 female,lounge_sit_casual_chat_clip2
637,recording_20210923_S13_S05_01,2399,2514,115,1 female,lounge_stand_up_and_lean_against_table_clip3
638,recording_20210923_S13_S05_01,2514,3064,550,1 female,lounge_walk_around_table_casual_chat_clip8
639,recording_20210923_S13_S05_01,3064,3277,213,1 female,lounge_lean_against_table_casual_chat_clip6
640,recording_20210923_S13_S05_01,3277,3849,572,1 female,lounge_walk_around_table_casual_chat_clip9
641,recording_20210923_S05_S13_02,3801,4340,539,1 female,lounge_stand_casual_chat_clip10
642,recording_20210923_S14_S03_01,841,1041,200,1 female,lounge_sit_down_and_lean_against_table_casual_chat_clip1
643,recording_20210923_S14_S03_01,1041,1458,417,1 female,lounge_sit_and_lean_against_table_casual_chat_clip1
644,recording_20210923_S14_S03_01,1458,1577,119,1 female,lounge_stand_up_casual_chat_clip4
645,recording_20210923_S14_S03_01,1577,1889,312,1 female,lounge_stand_casual_chat_clip11
646,recording_20210923_S14_S03_01,1889,2350,461,1 female,lounge_stand_casual_chat_clip12
647,recording_20210923_S14_S03_01,2350,2877,527,1 female,lounge_stand_casual_chat_clip13
648,recording_20210923_S14_S03_01,2877,3250,373,1 female,lounge_stand_casual_chat_clip14
649,recording_20210923_S03_S14_01,1211,1732,521,1 female,draw_with_hands_clip11
650,recording_20210923_S03_S14_01,1732,2355,623,1 female,draw_with_hands_clip12
651,recording_20210923_S03_S14_01,2355,2856,501,1 female,draw_with_hands_clip13
652,recording_20210923_S03_S14_01,2856,3250,394,1 female,draw_with_hands_clip14
653,recording_20210923_S14_S03_02,1101,1413,312,1 female,push_out_clip2
654,recording_20210923_S14_S03_02,1413,1610,197,1 female,punch_clip2
655,recording_20210923_S14_S03_02,1610,2042,432,1 female,play_badminton_clip2
656,recording_20210923_S14_S03_03,2201,2710,509,1 female,teacher_teach_courses_clip13
657,recording_20210929_S15_S11_01,1461,1961,500,1 male,studnet_attend_class_clip5
658,recording_20210929_S15_S11_01,1961,2461,500,1 male,studnet_attend_class_clip6
659,recording_20210929_S15_S11_01,2461,2961,500,1 male,studnet_attend_class_clip7
660,recording_20210929_S15_S11_01,2961,3461,500,1 male,studnet_attend_class_clip8
661,recording_20210929_S15_S11_01,3461,3990,529,1 male,studnet_attend_class_clip9
662,recording_20210929_S15_S11_02,4011,4422,411,1 male,studnet_attend_class_clip10
663,recording_20210929_S15_S11_02,4422,4920,498,1 male,studnet_attend_class_clip11
664,recording_20210929_S15_S11_03,881,1422,541,1 male,catch_toss_pick_up_pen_clip22
665,recording_20210929_S15_S11_03,1422,1922,500,1 male,catch_toss_pick_up_pen_clip23
666,recording_20210929_S15_S11_03,1922,2423,501,1 male,catch_toss_pick_up_pen_clip24
667,recording_20210929_S15_S11_03,2423,3010,587,1 male,catch_toss_pick_up_pen_clip25
668,recording_20210929_S05_S16_01,881,1422,541,1 female,discuss_with_others_clip39
669,recording_20210929_S05_S16_01,1422,1933,511,1 female,discuss_with_others_clip40
670,recording_20210929_S05_S16_01,1933,2488,555,1 female,discuss_with_others_clip41
671,recording_20210929_S05_S16_01,2488,3056,568,1 female,discuss_with_others_clip42
672,recording_20210929_S05_S16_01,3056,3633,577,1 female,discuss_with_others_clip43
673,recording_20210929_S05_S16_01,3633,4270,637,1 female,discuss_with_others_clip44
674,recording_20210929_S16_S05_01,1171,1655,484,1 female,discuss_with_others_clip45
675,recording_20210929_S16_S05_01,1655,2137,482,1 female,discuss_with_others_clip46
676,recording_20210929_S16_S05_01,2137,2655,518,1 female,discuss_with_others_clip47
677,recording_20210929_S16_S05_01,2655,3177,522,1 female,discuss_with_others_clip48
678,recording_20210929_S16_S05_01,3177,3688,511,1 female,discuss_with_others_clip49
679,recording_20210929_S16_S05_01,3688,4200,512,1 female,discuss_with_others_clip50
680,recording_20210929_S16_S05_01,4200,4650,450,1 female,discuss_with_others_clip51
681,recording_20210929_S16_S05_01,4650,5100,450,1 female,discuss_with_others_clip52
682,recording_20210929_S05_S16_02,1301,1801,500,1 female,casual_chat_clip88
683,recording_20210929_S05_S16_02,1801,2301,500,1 female,casual_chat_clip89
684,recording_20210929_S05_S16_02,2301,2801,500,1 female,casual_chat_clip90
685,recording_20210929_S05_S16_02,2801,3330,529,1 female,casual_chat_clip91
686,recording_20210929_S05_S16_03,751,1063,312,1 female,follow_to_act_clip1
687,recording_20210929_S05_S16_03,1063,1400,337,1 female,follow_to_act_clip2
688,recording_20210929_S05_S16_04,2351,2880,529,1 female,instruct_to_act_clip9
689,recording_20211002_S15_S17_01,1961,2533,572,1 male,casual_chat_clip92
690,recording_20211002_S15_S17_01,2533,3033,500,1 male,casual_chat_clip93
691,recording_20211002_S15_S17_01,3033,3533,500,1 male,casual_chat_clip94
692,recording_20211002_S15_S17_01,3533,4033,500,1 male,casual_chat_clip95
693,recording_20211002_S15_S17_01,4033,4530,497,1 male,casual_chat_clip96
694,recording_20211002_S17_S15_01,1321,1854,533,1 male,casual_chat_clip97
695,recording_20211002_S17_S15_01,1854,2433,579,1 male,casual_chat_clip98
696,recording_20211002_S17_S15_01,2433,2933,500,1 male,casual_chat_clip99
697,recording_20211002_S17_S15_01,2933,3500,567,1 male,casual_chat_clip100
698,recording_20211002_S17_S15_01,3500,4080,580,1 male,casual_chat_clip101
699,recording_20211002_S15_S17_02,1121,1621,500,1 male,casual_chat_clip102
700,recording_20211002_S15_S17_02,1621,2121,500,1 male,casual_chat_clip103
701,recording_20211002_S15_S17_02,2121,2621,500,1 male,casual_chat_clip104
702,recording_20211002_S15_S17_02,2621,3152,531,1 male,casual_chat_clip105
703,recording_20211002_S15_S17_02,3121,3740,619,1 male,casual_chat_clip106
704,recording_20211002_S17_S15_02,1141,1500,359,1 male,teach_to_work_out_clip1
705,recording_20211002_S17_S15_03,2141,2543,402,1 male,teach_to_work_out_clip2
706,recording_20211002_S17_S15_03,2543,2920,377,1 male,teach_to_work_out_clip3
707,recording_20211002_S03_S18_01,2301,2847,546,1 female,casual_chat_clip107
708,recording_20211002_S03_S18_01,2847,3440,593,1 female,casual_chat_clip108
709,recording_20211002_S03_S18_02,3811,4322,511,1 female,casual_chat_clip109
710,recording_20211002_S03_S18_02,4322,4711,389,1 female,casual_chat_clip110
711,recording_20211002_S03_S18_02,4711,5110,399,1 female,casual_chat_clip111
712,recording_20211002_S03_S18_03,1851,2447,596,1 male,casual_chat_clip112
713,recording_20211002_S03_S18_03,2447,3000,553,1 male,teach_to_toss_clip1
714,recording_20211002_S03_S18_03,3000,3510,510,1 male,teach_to_toss_clip2
715,recording_20211002_S03_S18_04,3601,4101,500,1 male,teach_to_work_out_clip4
716,recording_20211002_S03_S18_04,4101,4601,500,1 male,teach_to_work_out_clip5
717,recording_20211002_S03_S18_04,4601,5051,450,1 male,teach_to_work_out_clip6
718,recording_20211002_S03_S18_04,5051,5450,399,1 male,teach_to_work_out_clip7
719,recording_20211002_S18_S03_01,1441,1860,419,1 male,casual_chat_clip113
720,recording_20211002_S18_S03_02,2601,2960,359,1 male,casual_chat_clip114
721,recording_20211004_S19_S06_01,1601,2101,500,1 male,discuss_with_others_clip53
722,recording_20211004_S19_S06_01,2101,2601,500,1 male,discuss_with_others_clip54
723,recording_20211004_S19_S06_01,2601,3101,500,1 male,discuss_with_others_clip55
724,recording_20211004_S19_S06_01,3101,3601,500,1 male,discuss_with_others_clip56
725,recording_20211004_S19_S06_01,3601,4101,500,1 male,discuss_with_others_clip57
726,recording_20211004_S19_S06_01,4101,4670,569,1 male,discuss_with_others_clip58
727,recording_20211004_S19_S06_02,1711,2211,500,1 male,discuss_with_others_clip59
728,recording_20211004_S19_S06_02,2211,2711,500,1 male,discuss_with_others_clip60
729,recording_20211004_S19_S06_02,2711,3211,500,1 male,discuss_with_others_clip61
730,recording_20211004_S19_S06_02,3211,3530,319,1 male,discuss_with_others_clip62
731,recording_20211004_S19_S06_03,3781,4190,409,1 male,discuss_with_others_clip63
732,recording_20211004_S19_S06_04,1071,1571,500,1 male,casual_chat_clip115
733,recording_20211004_S19_S06_04,1571,2075,504,1 male,casual_chat_clip116
734,recording_20211004_S19_S06_04,2075,2533,458,1 male,casual_chat_clip117
735,recording_20211004_S19_S06_04,2533,2950,417,1 male,casual_chat_clip118
736,recording_20211004_S19_S06_05,3051,3394,343,1 male,casual_chat_clip119
737,recording_20211004_S19_S06_05,3394,3760,366,1 male,casual_chat_clip120
738,recording_20211004_S12_S20_01,1141,1641,500,1 male,casual_chat_clip121
739,recording_20211004_S12_S20_01,1641,2141,500,1 male,casual_chat_clip122
740,recording_20211004_S12_S20_01,2141,2641,500,1 male,casual_chat_clip123
741,recording_20211004_S12_S20_01,2641,3141,500,1 male,casual_chat_clip124
742,recording_20211004_S12_S20_01,3141,3541,400,1 male,casual_chat_clip125
743,recording_20211004_S12_S20_01,3541,3970,429,1 male,casual_chat_clip126
744,recording_20211004_S20_S12_01,1351,1935,584,1 male,studnet_attend_class_clip12
745,recording_20211004_S20_S12_01,1935,2535,600,1 male,studnet_attend_class_clip13
746,recording_20211004_S20_S12_01,2535,3135,600,1 male,studnet_attend_class_clip14
747,recording_20211004_S20_S12_01,3135,3635,500,1 male,studnet_attend_class_clip15
748,recording_20211004_S20_S12_01,3635,4180,545,1 male,studnet_attend_class_clip16
749,recording_20211004_S12_S20_02,1131,1567,436,1 male,teacher_teach_courses_clip14
750,recording_20211004_S12_S20_02,1567,2022,455,1 male,teacher_teach_courses_clip15
751,recording_20211004_S12_S20_02,2022,2420,398,1 male,teacher_teach_courses_clip16
752,recording_20211004_S20_S12_02,921,1251,330,1 male,take_phone_clip1
753,recording_20211004_S20_S12_02,1251,1587,336,1 male,casual_chat_clip127
754,recording_20211004_S20_S12_02,1587,1970,383,1 male,casual_chat_clip128
755,recording_20211004_S12_S20_03,951,1476,525,1 male,casual_chat_clip129
756,recording_20211004_S12_S20_03,1476,1706,230,1 male,teach_swim_clip1
757,recording_20211004_S12_S20_03,1706,2260,554,1 male,teach_ride_motorcycle_clip1
758,recording_20211004_S12_S20_03,2260,2655,395,0 female,casual_chat_clip130
759,recording_20211004_S12_S20_03,2655,3020,365,0 female,casual_chat_clip131
760,recording_20211004_S12_S20_04,3111,3650,539,1 male,casual_chat_clip132
761,recording_20211004_S20_S12_03,901,1350,449,1 male,casual_chat_clip133
762,recording_20211004_S20_S12_03,1350,1890,540,1 male,casual_chat_clip134
763,recording_20211004_S20_S12_04,1981,2435,454,1 male,learn_to_toss_clip6
764,recording_20211004_S20_S12_04,2435,2821,386,1 male,learn_fighting_clip2
765,recording_20211004_S20_S12_04,2821,3321,500,1 male,learn_to_toss_clip7
766,recording_20211004_S20_S12_04,3321,3719,398,1 male,learn_to_toss_clip8
767,recording_20211004_S20_S12_04,3719,4130,411,1 male,learn_fencing_clip2
768,recording_20220215_S21_S22_01,1901,2401,500,1 male,catch_toss_pick_up_clip17
769,recording_20220215_S21_S22_01,2401,2901,500,1 male,catch_toss_pick_up_clip18
770,recording_20220215_S21_S22_01,2901,3401,500,1 male,catch_toss_pick_up_clip19
771,recording_20220215_S21_S22_01,3401,3901,500,1 male,catch_toss_pick_up_clip20
772,recording_20220215_S21_S22_01,3901,4401,500,1 male,catch_toss_pick_up_clip21
773,recording_20220215_S21_S22_01,4401,4900,499,1 male,catch_toss_pick_up_clip22
774,recording_20220215_S22_S21_01,1541,2041,500,1 male,catch_toss_pick_up_clip23
775,recording_20220215_S22_S21_01,2041,2541,500,1 male,catch_toss_pick_up_clip24
776,recording_20220215_S22_S21_01,2541,3041,500,1 male,catch_toss_pick_up_clip25
777,recording_20220215_S22_S21_01,3041,3441,400,1 male,catch_toss_pick_up_clip26
778,recording_20220215_S22_S21_01,3441,3870,429,1 male,catch_toss_pick_up_clip27
779,recording_20220215_S22_S21_02,1411,1801,390,1 male,lying_on_sofa_pass_and_take_clip1
780,recording_20220215_S22_S21_02,1801,2166,365,1 male,lying_on_sofa_pass_and_take_clip2
781,recording_20220215_S22_S21_02,2166,2666,500,1 male,lying_on_sofa_pass_and_take_clip3
782,recording_20220215_S22_S21_02,2666,3166,500,1 male,lying_on_sofa_pass_and_take_clip4
783,recording_20220215_S22_S21_02,3166,3522,356,1 male,lying_on_sofa_pass_and_take_clip5
784,recording_20220215_S22_S21_02,3522,3950,428,1 male,lying_on_sofa_pass_and_take_clip6
785,recording_20220215_S22_S21_03,1221,1721,500,1 male,learn_TaiChi_clip12
786,recording_20220215_S22_S21_03,1721,2150,429,1 male,learn_TaiChi_clip13
787,recording_20220215_S21_S22_02,1511,2011,500,1 male,draw_with_hands_and_guess_clip1
788,recording_20220215_S21_S22_02,2011,2511,500,1 male,draw_with_hands_and_guess_clip2
789,recording_20220215_S21_S22_02,2511,3011,500,1 male,draw_with_hands_and_guess_clip3
790,recording_20220215_S21_S22_02,3011,3511,500,1 male,draw_with_hands_and_guess_clip4
791,recording_20220215_S21_S22_02,3511,4111,600,1 male,draw_with_hands_and_guess_clip5
792,recording_20220215_S21_S22_02,4111,4750,639,1 male,draw_with_hands_and_guess_clip6
793,recording_20220215_S22_S21_04,1461,2000,539,1 male,perform_eat_clip3
794,recording_20220215_S22_S21_04,2000,2390,390,1 male,perform_drink_clip2
795,recording_20220215_S22_S21_04,2390,2945,555,1 male,perform_eat_clip4
796,recording_20220215_S22_S21_04,2945,3500,555,1 male,draw_with_hands_clip15
797,recording_20220215_S22_S21_04,3500,4063,563,1 male,draw_with_hands_clip16
798,recording_20220215_S22_S21_04,4063,4630,567,1 male,draw_with_hands_clip17
799,recording_20220218_S23_S02_01,1551,2051,500,1 female,teach_to_dance_clip1
800,recording_20220218_S23_S02_01,2051,2551,500,1 female,teach_to_dance_clip2
801,recording_20220218_S23_S02_01,2551,3051,500,1 female,teach_to_dance_clip3
802,recording_20220218_S23_S02_01,3051,3551,500,1 female,teach_to_dance_clip4
803,recording_20220218_S23_S02_01,3551,3950,399,1 female,teach_to_dance_clip5
804,recording_20220218_S02_S23_01,2091,2591,500,1 female,stretch_clip11
805,recording_20220218_S02_S23_01,2591,3091,500,1 female,stretch_clip12
806,recording_20220218_S02_S23_01,3091,3591,500,1 female,stretch_clip13
807,recording_20220218_S02_S23_01,3591,4090,499,1 female,stretch_clip14
808,recording_20220218_S23_S02_02,1301,1801,500,1 female,dance_clip12
809,recording_20220218_S23_S02_02,1801,2301,500,1 female,dance_clip13
810,recording_20220218_S23_S02_02,2301,2801,500,1 female,dance_clip14
811,recording_20220218_S23_S02_02,2801,3301,500,1 female,dance_clip15
812,recording_20220218_S23_S02_02,3301,3700,399,1 female,dance_clip16
813,recording_20220218_S02_S23_02,2551,3051,500,1 female,dance_relax_clip6
814,recording_20220218_S02_S23_02,3051,3551,500,1 female,dance_relax_clip7
815,recording_20220218_S02_S23_02,3551,4051,500,1 female,dance_relax_clip8
816,recording_20220218_S02_S23_02,4051,4551,500,1 female,dance_relax_clip9
817,recording_20220218_S02_S23_02,4551,4950,399,1 female,dance_relax_clip10
818,recording_20220225_S24_S25_01,1901,2401,500,1 female,stand_casual_chat_clip63
819,recording_20220225_S24_S25_01,2401,2901,500,1 female,stand_casual_chat_clip64
820,recording_20220225_S24_S25_01,2901,3450,549,1 female,stand_casual_chat_clip65
821,recording_20220225_S24_S25_01,3450,4030,580,1 female,stand_casual_chat_clip66
822,recording_20220225_S25_S24_01,2441,2684,243,1 female,stretch_clip15
823,recording_20220225_S25_S24_01,2684,3184,500,1 female,teach_to_dance_clip6
824,recording_20220225_S25_S24_01,3184,3684,500,1 female,teach_to_dance_clip7
825,recording_20220225_S25_S24_01,3684,4240,556,1 female,teach_to_dance_clip8
826,recording_20220225_S24_S25_02,3031,3401,370,1 female,dance_clip17
827,recording_20220225_S24_S25_02,3401,3970,569,1 female,dance_clip18
828,recording_20220225_S26_S27_01,1901,2450,549,1 male,casual_chat_clip135
829,recording_20220225_S26_S27_01,2450,2950,500,1 male,casual_chat_clip136
830,recording_20220225_S26_S27_01,2950,3450,500,1 male,casual_chat_clip137
831,recording_20220225_S26_S27_01,3450,3850,400,1 male,casual_chat_clip138
832,recording_20220225_S26_S27_01,3850,4230,380,1 male,casual_chat_clip139
833,recording_20220225_S27_S26_01,2201,2601,400,1 male,stretch_clip16
834,recording_20220225_S27_S26_01,2601,3001,400,1 male,stretch_clip17
835,recording_20220225_S27_S26_01,3001,3550,549,1 male,stretch_clip18
836,recording_20220225_S27_S26_02,3571,3871,300,1 male,stretch_clip19
837,recording_20220225_S27_S26_02,3871,4250,379,1 male,stretch_clip20
838,recording_20220225_S27_S26_03,1670,1823,153,1 male,pass_tape_clip2
839,recording_20220225_S27_S26_03,1823,2423,600,1 male,casual_chat_clip140
840,recording_20220225_S27_S26_03,2423,2878,455,1 male,casual_chat_clip141
841,recording_20220225_S27_S26_03,2878,3239,361,1 male,casual_chat_clip142
842,recording_20220225_S27_S26_04,3401,3701,300,1 male,casual_chat_clip143
843,recording_20220225_S27_S26_04,3701,4060,359,1 male,casual_chat_clip144
844,recording_20220312_S28_S29_01,1661,2161,500,1 male,casual_chat_clip145
845,recording_20220312_S28_S29_01,2161,2661,500,1 male,casual_chat_clip146
846,recording_20220312_S28_S29_01,2661,3223,562,1 male,casual_chat_clip147
847,recording_20220312_S28_S29_01,3223,3480,257,1 male,take_check_card_clip4
848,recording_20220312_S28_S29_01,3480,3654,174,1 male,pass_card_clip2
849,recording_20220312_S28_S29_01,3654,4000,346,1 male,casual_chat_clip148
850,recording_20220312_S28_S29_01,4000,4370,370,1 male,casual_chat_clip149
851,recording_20220312_S28_S29_01,4370,4790,420,1 male,casual_chat_clip150
852,recording_20220312_S29_S28_01,1501,2001,500,1 male,catch_toss_pick_up_pen_clip26
853,recording_20220312_S29_S28_01,2001,2501,500,1 male,catch_toss_pick_up_pen_clip27
854,recording_20220312_S29_S28_01,2501,3001,500,1 male,catch_toss_pick_up_pen_clip28
855,recording_20220312_S29_S28_01,3001,3501,500,1 male,catch_toss_pick_up_pen_clip29
856,recording_20220312_S29_S28_01,3501,4001,500,1 male,catch_toss_pick_up_pen_clip30
857,recording_20220312_S29_S28_01,4001,4501,500,1 male,catch_toss_pick_up_pen_clip31
858,recording_20220312_S29_S28_01,4501,4960,459,1 male,catch_toss_pick_up_pen_clip32
859,recording_20220312_S28_S29_02,1401,1901,500,1 female,catch_toss_pick_up_clip28
860,recording_20220312_S28_S29_02,1901,2401,500,1 female,catch_toss_pick_up_clip29
861,recording_20220312_S28_S29_02,2401,2901,500,1 female,catch_toss_pick_up_clip30
862,recording_20220312_S28_S29_02,2901,3401,500,1 female,catch_toss_pick_up_clip31
863,recording_20220312_S28_S29_02,3401,3950,549,1 female,catch_toss_pick_up_clip32
864,recording_20220312_S29_S28_02,1401,2000,599,1 female,stand_casual_chat_clip67
865,recording_20220312_S29_S28_03,2221,2805,584,1 female,stand_casual_chat_clip68
866,recording_20220312_S29_S28_03,2805,3082,277,1 female,learn_ski_clip1
867,recording_20220312_S29_S28_03,3082,3582,500,1 female,stand_casual_chat_clip69
868,recording_20220312_S29_S28_03,3582,4050,468,1 female,stand_casual_chat_clip70
869,recording_20220312_S29_S28_03,4050,4340,290,1 female,learn_boat_clip1
870,recording_20220312_S29_S28_04,4561,5070,509,1 female,perform_drink_instant_coffee_clip2
871,recording_20220312_S28_S29_03,1301,1860,559,1 male,learn_ride_bike_clip1
872,recording_20220312_S28_S29_04,2021,2378,357,1 male,learn_dance_clip3
873,recording_20220312_S28_S29_04,2378,2792,414,1 male,learn_dance_clip4
874,recording_20220312_S28_S29_04,2792,3248,456,1 male,learn_skate_clip1
875,recording_20220312_S28_S29_04,3248,3360,112,0 female,learn_ballet_clip1
876,recording_20220312_S28_S29_05,3511,3850,339,1 male,learn_dance_clip5
877,recording_20220312_S29_S28_05,1411,1968,557,1 female,learn_TaiChi_clip14
878,recording_20220312_S29_S28_05,1968,2468,500,1 female,learn_TaiChi_clip15
879,recording_20220312_S29_S28_05,2468,2968,500,1 female,learn_TaiChi_clip16
880,recording_20220312_S29_S28_05,2968,3568,600,1 female,learn_TaiChi_clip17
881,recording_20220312_S29_S28_05,3568,4160,592,1 female,learn_TaiChi_clip18
882,recording_20220312_S28_S29_06,2051,2551,500,1 male,learn_TaiChi_clip19
883,recording_20220312_S28_S29_06,2551,3051,500,1 male,learn_TaiChi_clip20
884,recording_20220312_S28_S29_06,3051,3551,500,1 male,learn_TaiChi_clip21
885,recording_20220312_S28_S29_06,3551,4051,500,1 male,learn_TaiChi_clip22
886,recording_20220312_S28_S29_06,4051,4600,549,1 male,learn_TaiChi_clip23
887,recording_20220315_S21_S30_01,2571,3071,500,1 male,casual_chat_clip151
888,recording_20220315_S21_S30_01,3071,3571,500,1 male,casual_chat_clip152
889,recording_20220315_S21_S30_01,3571,4100,529,1 male,casual_chat_clip153
890,recording_20220315_S21_S30_01,4100,4690,590,1 male,casual_chat_clip154
891,recording_20220315_S30_S21_01,1401,1845,444,1 male,run_clip2
892,recording_20220315_S30_S21_01,1845,2184,339,1 male,squat up_clip2
893,recording_20220315_S30_S21_01,2184,2621,437,1 male,stretch_clip21
894,recording_20220315_S30_S21_01,2621,2962,341,1 male,jump_jack_clip4
895,recording_20220315_S30_S21_01,2962,3134,172,1 male,pass_water_clip1
896,recording_20220315_S30_S21_01,3134,3686,552,1 male,casual_chat_clip155
897,recording_20220315_S30_S21_01,3686,3940,254,1 male,kick_up_clip3
898,recording_20220315_S21_S30_02,1501,1879,378,1 male,bow_clip2
899,recording_20220315_S21_S30_02,1879,2379,500,1 male,teach_TaiChi_clip13
900,recording_20220315_S21_S30_02,2379,2890,511,1 male,teach_TaiChi_clip14
901,recording_20220315_S21_S30_03,3161,3650,489,1 male,teach_TaiChi_clip15
902,recording_20220315_S21_S30_03,3650,4100,450,1 male,teach_TaiChi_clip16
903,recording_20220315_S21_S30_04,4131,4670,539,1 male,teach_TaiChi_clip17
904,recording_20220315_S30_S21_02,1031,1531,500,1 male,teach_TaiChi_clip18
905,recording_20220315_S30_S21_02,1531,2031,500,1 male,teach_TaiChi_clip19
906,recording_20220315_S30_S21_02,2031,2531,500,1 male,teach_TaiChi_clip20
907,recording_20220315_S30_S21_02,2531,3031,500,1 male,teach_TaiChi_clip21
908,recording_20220315_S30_S21_02,3031,3531,500,1 male,teach_TaiChi_clip22
909,recording_20220315_S30_S21_02,3531,4130,599,1 male,teach_TaiChi_clip23
910,recording_20220315_S21_S30_05,1301,1862,561,1 male,jump_jack_clip5
911,recording_20220315_S21_S30_05,1862,2314,452,1 male,kick_up_clip4
912,recording_20220315_S21_S30_05,2314,2614,300,1 male,dance_clip19
913,recording_20220315_S21_S30_05,2614,3000,386,1 male,dance_clip20
914,recording_20220315_S21_S30_06,3181,3581,400,1 male,dance_clip21
915,recording_20220315_S21_S30_06,3581,3990,409,1 male,dance_clip22
916,recording_20220318_S31_S32_01,1810,2310,500,1 female,casual_chat_clip156
917,recording_20220318_S31_S32_01,2310,2810,500,1 female,casual_chat_clip157
918,recording_20220318_S31_S32_01,2810,3310,500,1 female,casual_chat_clip158
919,recording_20220318_S31_S32_01,3310,3610,300,1 female,casual_chat_clip159
920,recording_20220318_S31_S32_01,3610,4110,500,1 female,casual_chat_clip160
921,recording_20220318_S31_S32_01,4110,4560,450,1 female,casual_chat_clip161
922,recording_20220318_S32_S31_01,1626,2000,374,1 female,casual_chat_clip162
923,recording_20220318_S32_S31_01,2000,2541,541,1 female,casual_chat_clip163
924,recording_20220318_S32_S31_01,2541,2941,400,1 female,explain_on_blackboard_clip1
925,recording_20220318_S32_S31_01,2941,3341,400,1 female,explain_on_blackboard_clip2
926,recording_20220318_S32_S31_01,3341,3741,400,1 female,explain_on_blackboard_clip3
927,recording_20220318_S32_S31_01,3741,4279,538,1 female,explain_on_blackboard_clip4
928,recording_20220318_S32_S31_01,4279,4875,596,1 female,casual_chat_clip164
929,recording_20220318_S32_S31_02,1621,2121,500,1 female,perform_animals_clip6
930,recording_20220318_S32_S31_02,2121,2621,500,1 female,perform_animals_clip7
931,recording_20220318_S32_S31_02,2621,3121,500,1 female,perform_animals_clip8
932,recording_20220318_S32_S31_02,3121,3421,300,1 female,perform_animals_clip9
933,recording_20220318_S32_S31_02,3421,3835,414,1 female,perform_animals_clip10
934,recording_20220318_S32_S31_02,3835,4055,220,1 female,perform_to_write_clip2
935,recording_20220318_S32_S31_02,4055,4158,103,1 female,peform_to_sleep_clip1
936,recording_20220318_S32_S31_02,4158,4380,222,1 female,run_clip3
937,recording_20220318_S34_S33_01,2151,2651,500,1 male,discuss_with_others_clip64
938,recording_20220318_S34_S33_01,2651,3160,509,1 male,discuss_with_others_clip65
939,recording_20220318_S34_S33_02,3501,4001,500,1 male,casual_chat_clip165
940,recording_20220318_S34_S33_02,4001,4550,549,1 male,casual_chat_clip166
941,recording_20220318_S34_S33_02,4550,5140,590,1 male,casual_chat_clip167
942,recording_20220318_S34_S33_03,1701,2201,500,1 male,explain_on_blackboard_clip5
943,recording_20220318_S34_S33_03,2201,2701,500,1 male,explain_on_blackboard_clip6
944,recording_20220318_S34_S33_03,2701,3201,500,1 male,explain_on_blackboard_clip7
945,recording_20220318_S34_S33_03,3201,3701,500,1 male,explain_on_blackboard_clip8
946,recording_20220318_S34_S33_03,3701,4101,400,1 male,explain_on_blackboard_clip9
947,recording_20220318_S34_S33_03,4101,4670,569,1 male,explain_on_blackboard_clip10
948,recording_20220318_S33_S34_01,2691,3190,499,1 female,explain_on_blackboard_clip11
949,recording_20220318_S33_S34_01,3190,3690,500,1 female,explain_on_blackboard_clip12
950,recording_20220318_S33_S34_01,3690,4190,500,1 female,explain_on_blackboard_clip13
951,recording_20220318_S33_S34_01,4190,4690,500,1 female,explain_on_blackboard_clip14
952,recording_20220318_S33_S34_01,4690,5150,460,1 female,explain_on_blackboard_clip15
953,recording_20220318_S33_S34_02,2001,2544,543,1 female,casual_chat_clip168
954,recording_20220318_S33_S34_02,2544,2930,386,1 female,arms_up_and_down_clip2
955,recording_20220318_S33_S34_02,2930,3226,296,1 female,squat_down_and_then_stand_up_clip2
956,recording_20220318_S33_S34_02,3226,3826,600,1 female,stretch_clip22
957,recording_20220318_S33_S34_02,3826,4316,490,1 female,stretch_clip23
958,recording_20220318_S33_S34_02,4316,4574,258,1 female,jump_jack_clip6
959,recording_20220415_S36_S35_01,1401,1901,500,1 male,discuss_about_book_clip6
960,recording_20220415_S36_S35_01,1901,2401,500,1 male,discuss_about_book_clip7
961,recording_20220415_S36_S35_01,2401,2901,500,1 male,discuss_about_book_clip8
962,recording_20220415_S36_S35_01,2901,3401,500,1 male,discuss_about_book_clip9
963,recording_20220415_S36_S35_01,3401,3950,549,1 male,discuss_about_book_clip10
964,recording_20220415_S36_S35_02,1801,2201,400,1 male,casual_chat_clip169
965,recording_20220415_S36_S35_02,2201,2601,400,1 male,casual_chat_clip170
966,recording_20220415_S36_S35_02,2601,3001,400,1 male,casual_chat_clip171
967,recording_20220415_S36_S35_02,3001,3501,500,1 male,casual_chat_clip172
968,recording_20220415_S36_S35_02,3501,4000,499,1 male,casual_chat_clip173
969,recording_20220415_S35_S36_01,951,1451,500,1 male,casual_chat_clip174
970,recording_20220415_S35_S36_01,1451,1951,500,1 male,casual_chat_clip175
971,recording_20220415_S35_S36_01,1951,2451,500,1 male,casual_chat_clip176
972,recording_20220415_S35_S36_01,2451,3050,599,1 male,casual_chat_clip177
973,recording_20220415_S35_S36_01,3050,3570,520,1 male,casual_chat_clip178
974,recording_20220415_S35_S36_02,1001,1350,349,1 male,perform_cutting_clip1
975,recording_20220415_S35_S36_02,1350,1780,430,1 male,perform_cutting_clip2
976,recording_20220415_S35_S36_02,1780,2200,420,1 male,perform_baking_clip1
977,recording_20220415_S35_S36_02,2200,2600,400,1 male,perform_baking_clip2
978,recording_20220415_S35_S36_02,2600,3000,400,1 male,perform_baking_clip3
979,recording_20220415_S35_S36_02,3000,3480,480,1 male,perform_baking_clip4
